##########
#        #
#        #
#        #
#        #
#        #
# o      #
# X      #
#        #
##########
